################
#        #######
#●            ■# 
#        ####### 
#        #     # 
##       #  ▲  # 
###  ▲   #     # 
################
⋆ ◌ ◊ ◙ ◘