# # # # # # # # # # # # # # # #
# - - - - - - - - # # # # # # #
# - ● - - - - - - - - - - - ■ # 
# - - - - - - - - # # # # # # # 
# - - - - ◙ - - - # - - - - - # 
# # - - - - - - - # - - ◘ - - # 
# # # - ▲ - - - - # - - - - - # 
# # # # # # # # # # # # # # # # 




