#  #  #  #  #  #  #  #  #  #  #  #  #  #  #  #
#  -  -  -  -  -  -  -  -  -  -  -  -  -  ◘  #
#  -  -  -  -  -  -  -  -  -  -  -  -  -  ■  #
#  -  -  -  -  -  -  -  -  -  -  -  -  -  -  #
#  -  -  -  -  -  -  -  -  -  -  -  -  -  -  #
#  -  -  -  -  -  -  -  -  -  -  -  -  -  -  #
#  -  -  -  -  -  -  -  -  -  -  -  -  -  -  #
#  -  -  -  -  -  -  -  -  -  -  -  -  -  -  #
#  -  -  ●  -  -  -  -  -  -  -  -  -  -  -  #
#  ▲  -  -  -  -  -  -  -  -  -  -  -  -  -  #
#  #  #  #  #  #  #  #  #  #  #  #  #  #  #  #  

