#  #  #  #  #  #  #  #  #  #  #  #  #  #  #  #
#  ▲  -  -  -  #  ◘  ◘  #  -  -  -  -  -  ◊  #
#  -  -  -  -  #  #  #  #  -  -  -  -  -  -  #
#  -  -  -  -  -  -  -  -  -  -  ◙  -  -  -  #
#  #  #  #  #  #  #  #  #  -  -  -  ●  -  -  #
#  ▲  ▲  -  -  -  -  -  -  -  -  ◙  -  -  ■  #
#  #  #  #  #  #  #  #  #  -  -  -  -  -  -  #
#  -  -  -  -  -  -  -  -  -  -  ◙  -  -  -  #
#  -  #  #  #  #  #  #  #  -  -  -  -  -  -  #
#  -  -  -  -  -  -  ▲  #  -  -  -  -  -  ◊  #
#  #  #  #  #  #  #  #  #  #  #  #  #  #  #  #  

