#  #  #  #  #  #  #  #  #  #  #  #  #  #  #
#  ▲  -  -  -  -  -  -  -  -  -  -  #  ◘  #
#  #  #  #  #  #  #  #  -  ●  -  -  #  #  #
#  ▲  #  -  -  -  -  -  -  ◙  -  -  #  #  #
#  -  #  -  -  -  -  -  -  -  -  -  -  #  #
#  -  #  -  ◊  -  -  -  -  ◙  -  ■  -  #  #
#  -  #  -  -  -  -  -  -  -  -  -  -  #  #
#  -  #  -  -  -  -  -  -  -  -  -  -  #  #
#  -  #  #  #  #  #  #  #  -  -  -  #  #  #
#  -  -  -  -  -  -  -  -  -  -  -  #  ◘  #
#  #  #  #  #  #  #  #  #  #  #  #  #  #  #  

