#  #  #  #  #  #  #  #  #  #  #  #  #  #  #  #
#  -  -  -  -  -  -  -  -  -  -  -  -  #  #  #
#  -  #  ◙  #  #  #  #  #  #  #  -  -  -  -  #  
#  -  #  -  -  #  -  -  -  -  #  -  -  -  -  #  
#  -  #  -  -  #  -  ●  -  -  #  -  -  -  -  #  
#  -  #  ■  -  #  -  -  -  -  #  -  -  -  -  #  
#  -  #  #  #  #  -  ◙  -  -  #  #  #  ◙  #  #  
#  -  #  ▲  -  #  -  -  -  -  -  -  -  -  -  #
#  -  #  #  -  #  #  #  #  #  #  #  #  #  -  #
#  -  -  -  -  -  -  -  -  -  -  -  -  #  ▲  #
#  #  #  #  #  #  #  #  #  #  #  #  #  #  #  #  

