#  #  #  #  #  #  #  #  #  #  #  #  #  #  #  #
#  ◘  -  #  -  -  -  -  -  -  -  -  -  -  -  #
#  -  -  #  -  -  -  -  ◙  -  -  -  -  ◊  -  #
#  #  #  #  -  -  -  -  -  -  -  -  -  -  -  #
#  -  -  -  -  -  #  #  #  #  #  -  -  #  #  #
#  -  ■  -  ●  - 30  ▲  #  ▲ 14  -  -  #  #  #
#  -  -  -  -  -  #  #  #  #  #  -  -  #  #  #
#  #  #  #  -  -  -  -  -  -  -  -  -  -  -  #
#  -  -  #  -  -  -  -  ◙  -  -  -  -  ◊  -  #
#  ◘  -  #  -  -  -  -  -  -  -  -  -  -  -  #
#  #  #  #  #  #  #  #  #  #  #  #  #  #  #  #  

