#  #  #  #  #  #  #  #  #  #  #  #  #  #  #  #
#  -  -  -  -  -  -  -  -  -  -  -  -  -  -  #
#  -  #  #  #  #  #  -  -  #  #  #  #  #  -  #
#  -  -  -  -  ▲  ◙  -  -  ◙  ▲  -  -  -  -  #
#  #  ◙  #  #  #  #  -  -  #  #  #  #  ◙  #  #
#  -  -  #  #  #  #  -  -  #  #  #  #  -  -  #
#  ◊  -  #  -  -  #  ●  -  #  -  -  #  -  ■  #
#  #  #  #  -  ◙  -  -  -  -  ◙  -  #  #  #  #
#  -  -  #  -  -  -  -  -  -  -  -  #  -  -  #
#  ◘  -  #  -  -  -  -  -  -  -  -  #  -  ◘  #
#  #  #  #  #  #  #  #  #  #  #  #  #  #  #  #  

