#  #  #  #  #  #  #  #  #  #  #  #  #  #  #  #
#  -  -  -  -  -  -  -  -  -  -  ▲  -  -  -  #
#  -  -  -  -  -  -  #  #  #  #  #  #  #  #  #
#  -  -  -  -  -  -  -  -  -  -  -  -  #  ■  #
#  -  -  -  -  -  -  -  -  -  -  -  -  -  -  #
#  -  -  -  -  -  -  -  -  -  -  -  -  -  -  #
#  -  -  -  -  -  ◙  -  -  -  -  -  -  -  -  #
#  -  -  -  #  #  ◘  #  #  -  -  -  -  -  -  #
#  -  ●  -  #  ◘  ◘  ◘  #  -  -  -  -  -  -  #
#  -  -  -  #  ◘  ◘  ◘  #  -  -  -  -  -  -  #
#  #  #  #  #  #  #  #  #  #  #  #  #  #  #  #  

