#  #  #  #  #  #  #  #  #  #  #  #  #  #  #  #
#  ◊  -  -  -  -  -  -  ◊  #  -  -  -  #  ▲  #
#  -  -  -  -  -  -  -  -  #  -  #  -  #  ▲  #
#  -  -  -  -  -  ◙  -  -  #  -  #  -  #  ▲  #
#  -  -  -  -  -  -  -  -  #  -  #  -  #  ▲  #
#  ■  -  -  ◙  -  ●  -  ◌  -  -  #  -  #  ▲  #
#  -  -  -  -  -  -  -  -  #  #  #  -  #  ▲  #
#  -  -  -  -  -  ◙  -  -  #  -  -  -  #  ◌  #
#  -  -  -  -  -  -  -  -  #  -  #  #  #  -  #
#  ◊  -  -  -  -  -  -  ◊  #  -  -  -  -  -  #
#  #  #  #  #  #  #  #  #  #  #  #  #  #  #  #  

