#  #  #  #  #  #  #  #  #  #  #  #  #  #  #  #
#  -  -  -  -  -  -  ■  -  -  -  -  -  #  #  #
#  -  ◊  -  -  -  -  -  -  -  -  -  -  -  #  #
#  -  -  -  -  -  -  -  -  -  -  -  -  -  -  #
#  -  -  -  -  -  -  ◙  -  -  -  -  -  -  -  #
#  -  ●  -  -  -  ◙  ◘  ◙  -  -  -  -  -  ▲  #
#  -  -  -  -  -  -  ◙  -  -  -  -  -  -  -  #
#  -  -  -  -  -  -  -  -  -  -  -  -  -  -  #
#  -  ◊  -  -  -  -  -  -  -  -  -  -  -  #  #
#  -  -  -  -  -  -  -  -  -  -  -  -  #  #  #
#  #  #  #  #  #  #  #  #  #  #  #  #  #  #  #  

