#  #  #  #  #  #  #  #  #  #  #  #  #  #  #  #
#  -  #  ▲  ▲  ▲  ▲  ▲  ▲  ▲  ▲  ▲  ▲  #  -  #
#  -  #  ▲  ▲  ▲  ▲  ◊  ◊  ▲  ▲  ▲  ▲  #  -  #
#  -  #  ▲  ▲  ◙  ◙  ◙  ◙  ◙  ◙  ▲  ▲  #  -  #
#  -  #  ▲  ▲  ◙  -  -  -  -  ◙  ▲  ▲  #  -  #
#  ◘  #  ▲  ◊  ◙  -  ●  ■  -  ◙  ◊  ▲  #  ◘  #
#  -  #  ▲  ▲  ◙  -  -  -  -  ◙  ▲  ▲  #  -  #
#  -  #  ▲  ▲  ◙  ◙  ◙  ◙  ◙  ◙  ▲  ▲  #  -  #
#  -  #  ▲  ▲  ▲  ▲  ◊  ◊  ▲  ▲  ▲  ▲  #  -  #
#  -  #  ▲  ▲  ▲  ▲  ▲  ▲  ▲  ▲  ▲  ▲  #  -  #
#  #  #  #  #  #  #  #  #  #  #  #  #  #  #  # 