#  #  #  #  #  #  #  #  #  #  #  #  #  #  #  #
#  ▲  -  -  #  -  -  -  -  -  -  -  -  ■  -  #
#  ▲  -  -  #  #  -  -  -  -  -  -  -  -  -  #  
#  ▲  -  -  -  -  -  -  -  -  -  -  #  #  #  #  
#  ▲  -  -  #  #  -  -  -  -  ◙  -  -  -  -  #  
#  ▲  -  -  #  -  -  -  -  -  -  -  #  #  -  #  
#  ▲  -  -  #  -  -  -  -  -  -  -  -  #  -  #  
#  ▲  -  -  #  -  ◙  -  -  -  -  -  -  #  -  #
#  ▲  -  -  #  -  -  -  -  -  -  -  -  #  -  #
#  ▲  -  -  #  -  ●  -  -  -  -  -  -  #  ▲  #
#  #  #  #  #  #  #  #  #  #  #  #  #  #  #  #  

