#  #  #  #  #  #  #  #  #  #  #  #  #  #  #  #
#  -  -  -  -  -  -  -  -  -  -  -  -  -  ◘  #
#  -  -  -  -  -  -  -  -  -  -  -  ■  -  -  #
#  -  -  -  -  -  -  -  -  -  -  -  -  -  -  #
#  -  -  -  -  -  -  -  -  -  -  -  -  -  -  #
#  -  -  -  -  -  -  -  -  -  -  -  -  -  -  #
#  -  -  -  -  -  -  -  -  -  -  -  -  -  -  #
#  -  -  -  -  -  -  -  -  -  -  -  -  -  -  #
#  -  -  ●  -  -  -  -  -  -  -  -  -  -  -  #
#  ▲  -  -  -  -  -  -  -  -  -  -  -  -  -  #
#  #  #  #  #  #  #  #  #  #  #  #  #  #  #  #  

